LEVEL 6
##########
#........#
#...P....#
#...<....#
#........#
#........#
#.....>..#
##########
