LEVEL 8
##########
#...P<...#
#........#
#........#
#........#
#........#
#...>....#
##########
