##########
#........#
#.<......#
#........#
#...P....#
#........#
#....>...#
##########