LEVEL 5
##########
#.<......#
#.P......#
#........#
#........#
#........#
#.....>..#
##########
