LEVEL 4
####################
#..................#
#..................#
#..........>.......#
#..................#
#.......P..........#
#..................#
#..................#
#..........<.......#
####################
