LEVEL 7
##########
#...>....#
#........#
#........#
#........#
#.....<..#
#.....P..#
##########
