LEVEL 3
##########
#......<.#
#......>.#
#........#
#........#
#.....P..#
#........#
##########