LEVEL 2
##########
#........#
#........#
#....P...#
#........#
#....>...#
#....<...#
##########