LEVEL 1
##########
#........#
#..P.....#
#....>...#
#........#
#........#
#....<...#
##########